21 21
#####################
        #     #     #
# # # ### ##### ### #
# # # #     #     # #
# ##### # # ##### ###
#       # # # #     #
# ### ##### # # #####
# #     # #         #
### ### # # ### ### #
# #   # #     # #   #
# ### ### # # ##### #
#   # #   # #   #   #
# # ##### ### # #####
# #   #     # #   # #
# ### ### ##### ### #
# #           # # # #
### ### ######### # #
#     #       #     #
### ##### ######### #
#     #             
#####################
