101 101
#####################################################################################################
  #   #   # #   # #     # #       #                 # #   # #   #   #         #     #   #         # #
# ### ### # # # # # # # # ####### ############### ### # # # # # ### ####### ### ### ### ##### ### # #
#     #       #   # # #         #       # #   #       # # #   # # # #   #     # # #   # #   # #     #
# ########### ##### ##### # ### # ### ### ### # ### ### # # ##### # # ### # ### # # ### # ##### #####
#   #   #         # #     #   # #   #     #     #   #   #     #     #     #   # # #       # #       #
### ### # # ####### ##### ### ####### # ### ### # ### # ##### # ##### ##### # # # ### ### # ### # ###
#         #   # #     # #   # #   #   #   # #   #   # #     #           # # # #     # #   # # # # # #
# ##### ##### # # ##### ### ### ##### # ########### ### # ### ### ##### # # # # # ######### # # # # #
#   # #   #     #         # # # # # # # #     # #     # # #     #     # # # #   # #       # #   #   #
##### ######### ### # ### # # # # # # ### # # # ### ####### ####### # ### ############### # # ##### #
#         # #     # # #   #     # #   #   # # # #   #       #   # # #           #         # # #     #
######### # ##### ######### # ### ### ##### ### # ####### ### ### # ##### ##### # # ### ### ####### #
#   # #     #       # #     # #   # #   #         # # # #   #   #   #   # #   #   #   #   # # #     #
### # # ########### # ### ### # # # # ##### ### ### # # # ### ### # # # ##### ### ####### # # ### ###
# # # #   # #   #   # # #   # # # #           #         #     #   #   #       #   #   # #         # #
# # # # ### # # ### # # ### # # ### # ### ### ### ######### ### ######### ####### # ### # ### ##### #
#           # # #     #     # #     # #     # #   # #   # # # #   #           # # #   #     # # #   #
### # ##### # ### ######### ### ##### # ##### ### # ### # ### # # # ##### ##### # ### # ##### # ### #
#   #   #           #   #     #     # #   #   #     #     #     # # # # #     # # # #     #     #   #
####### ####### ### ### # # ### ##### ##### ##### # ### ########### # # # ### # # # ### # ### # # ###
#       #     # #         #   # # #       # #     # #           #     #   #   #       # #   # # #   #
# ######### ##### ########### ### # ### # ### ########### ### # # # ####### ##### ##### ### # # ### #
#         # # #     # # # #     #     # #   # # #   # # # # # # # # # #       # # #   #   # # # #   #
######### # # ### ### # # ######### # ### # ### # ### # # # ### ##### # ### # # ##### ######### ### #
# #   #     # # #     #   # #     # #   # #     #   #     # #   #         # # #     # #       # # # #
# ### # # # # # ### ### ### ### ####### ### ### ### # ### # ##### # ### ### # ### ### ### # ##### # #
#   #   # #     #         # #     #   # #     # #   #   #   # # # #   #   # # # # #     # #         #
# ### ### # # # ### ####### ##### # # # ### ##### ### ##### # # ### ####### # # # ##### # ##### # ###
#     #   # # #   #     #   #       #   #   #   #       # #   #   # #   #   #   # #   #   #   # #   #
### ####### ########### ### ### ### # # ### ### ### # ### # # # ### ### # # ### # # # # ### # # ### #
# #   #     # # #     #         # # # #   #         # #     #   #       # #   # #   #   # # #     # #
# ### ##### # # # # ##### ##### # # ### ######### ##### ##### # # # # ##### # ####### ### ### ##### #
#   # # # #     # #       # # #   # #     #   #       # #     # # # # #   # #   #         #   #     #
# ##### # # # # ##### # # # # ### # ##### # ############# ### ######### ##### ### # ### # ####### ###
#     # #   # # #     # #   # #   # #   #   #         #     # #         #         # #   #       #   #
# ##### # ### ### ### # # # # ### ##### ######### ########### ####### # # ######### ########### #####
#   #     # #   #   # # # #   #     #       # # #   # # #   # #       #   #       #   #     # # #   #
### # ##### ##### ### # ##### ####### ### # # # # ### # ### ### # ### # ##### ##### # ### ### ### ###
# # # #       # # # # # #   #     #     # #     #   #       #   #   # # #       # # #   #   # #   # #
# # # ### # ### # # ##### ##### # # # # # ####### ##### # ### ######### ### ### # # ##### ### # # # #
#   # # # # #   # #   # #   #   #   # # #     # #   #   #   # #   #     #   #   # # #   # #     #   #
# ##### # ### ##### # # ### # # ### # ### # ### ### ####### ### # # # ##### ### # ##### # ######### #
# #         #   #   #         # #   #   # #     # #   #   #   # # # #         #         # #         #
# ##### ##### ### ### ##### ##### ##### ####### # ### # # ### # # ### ### ##### ##### # # ### ##### #
#       #       # #       #   # #     # # #   # #     # # #     #       # #       #   #     #     # #
# # ### # ##### ##### ####### # ####### # ### ### # ### # ##### # ### ##### # ### # # # # ######### #
# # # #   #         # #         # # #     #     # #     # #   # # # #   # # #   # # # # #       #   #
### # ######### ##### ####### ### # # ######### # # ### ### ##### # ##### ########### # # ### ### # #
#     #   #       # # #   # # #   #         #   # #   # #                     #   # # # #   #   # # #
### ### # ### # ### # # ### # # ##### # # ### ### ### # # ### ### ##### ####### ### # # ### # ### # #
#     # #     # #   #     # # #   #   # #   #       # #   #     #     #     # #       # # # # #   # #
# ##### ### ##### # ####### ##### ### ######### ### ######### ##### # ### # # ### ##### # # ##### # #
#   # # #       # #       #         # # #   # # #   # # #       #   # #   # #         #   #     # # #
##### ##### # ##### # ####### ### # # # # # # ### # # # # ############# ######### ########### # # # #
# #       # # #     # #   # #   # #     # #   #   # #           # #   #   #       #   #     # #   # #
# ####### ### # ### ##### # # ##### ### ### ######### ##### # ### ### ####### ### # # # ##### ### # #
#   #   #       #         #     #     # #   #         #     #   #   #   #     #     # # #   # # # # #
# ##### ### ##### ####### # # ##### # ### # ####### ### ### # ### # ### ### ### # ##### # ### # ### #
# #     #       # # # #   # # # #   #   # # #     # # # #   #     #   # #     # # # #   # # # # # # #
# ##### ##### ##### # ####### # ### # ##### ### # # # ### # ### # ##### ##### # ### # # # # # # # # #
#       #   # #         # #     #   #   # # #   # #   # # #   # # #     # #   #     # #     # #   # #
### ##### # # # # ##### # ####### ##### # # # ### # ### ### # # # ##### # ######### # # ####### #####
#         #     #     #     #     # #       # #     # #   # # # #     #     # # #     #   #   #   # #
# # ### ### ####### # # # # ### # # ####### ######### ### # # # ### ### # # # # ##### ### ### ### # #
# # #     # # # #   # # # # #   #   #   #   # #   # #       # # # #   # # #   #         # #       # #
# # ### ### # # # # ### ##### # ####### # # # # # # # ##### # # # ########### # # ### # ### # # ### #
# # #   #   # #   #   # #   # #   #       #     #     # #   # #   #       #     # # # # # # # #     #
##### # ##### # ##### # # ### ################# # ##### ##### ### # ##### # # # ### # # # ##### #####
# #   #     #   #     #     # # #     #   #     #   # #   #   # # #   #   # # #     # # #           #
# ### ##### ####### # # ##### # # # ### ########### # # ##### # ######### ####### ### ### ###########
#   # # #         # # #         # # #   #     # #   #         #     #     # #   #   # # # # #     # #
# ### # ####### ########### ### # ##### # # ### ### ### # ### # ### # ##### # ##### ### # # # ##### #
# #     #         #   # # # # # #         #   # #   # # #   # #   #   #   # #   #   # # #   #     # #
# ########### ### # ### # # # ### ##### # # ### # # # ####### ### ### # ### ### ### # # ### # # ### #
#           # # # #   #     #   # # #   # #       #     #     #   #   #   #     # #           # #   #
##### ### # ### ##### # ### # ##### ##### ####### ### ### ##### ######### ##### # # ### ### ##### ###
#       # # # #   # #     #     # # #     #   # # #   # # #     # #       #   #     #   #       #   #
####### ### # # ### # # ####### # # ##### # ### ####### # # ##### # ##### # ### ##### ##### ####### #
#   #   #       #     #     # #   #     # # #   #         #       #     # # #     #   #           # #
# ### ### ### # ### ### ##### # ### ####### # # ##### ##### ### ##### ##### ##### # # # # # ##### # #
#       # #   #       # #     #   #     #     #   #     # # #   #                 # # # # # #   #   #
# ####### ########### # # ### ##### ### ### ### ####### # ##### ##### # # ### # ##### ##### # #######
#   # #   #   #       #     #     #   #   # #     # # #   #       # # # # # # #   #     #   #       #
### # ### ### # # ### # ####### ##### ### ##### ### # ##### # ### # ### ### # ####### ### ### # ### #
#   #   #     # #   # #   #       #     #     # #   #       # #   #   #     #   #   # #     # #   # #
# ##### # ### ########### ##### # # # # ### ### ### ####### ### ##### ####### # ### ### ##### #######
#   #       #     # #   # # #   #   # # #         #         # # #             # # #     #   # #   # #
# # # # # ##### # # # ##### # ### ######### ####### ##### ### ### ####### # ##### # ### ### # ### # #
# # # # #   #   #   # # #   # # #       #       #   #   #       #       # #     #     # # #         #
# ##### # ##### ### # # ### # # # ####### ####### ##### ##### # # ### ######### ##### ### # # # #####
#   # # # # #   #     #   #   #   #   #   #   #   # # # # #   #   # #   #       #   #       # # #   #
##### ### # # ### ##### # ### # ### # ##### ####### # # # ##### ### # ####### ### ##### ### ### # ###
#     #     #   #   # # # #   #     # #     # #   # # #         #         # # # # # #   #   #   #   #
# ### # # # ####### # ### ##### ##### ### # # # ### # # ### ##### # ### ### # # # # ### # ######### #
# #   # # # #       #   # #   #     #     #       #       #   # # # # #     #   #   #   #   #   #   #
# ##### ####### ##### # # # # # # # # ##### ### ### ### ### ### ### # ##### # # # ####### ### # # ###
# #   #   #     #     #   # # # # # #     # # # #   #   #     # #   # # #   # #     # # #   # #   # #
# # # ### # # ### ### ##### ### ### # ##### # ### ### # ##### # ### # # ### # # # # # # # # ### ### #
#   #     # #   # #             #   #   #       # #   # #     #       #     # # # # #     #          
#####################################################################################################
